111111111111111111111111111
1000000000C111C10000000E001
100000P01111M00100100000001
100C10001C11000000C00110001
100M00000000000000000000001
1M000000000000C00C000MC00M1
111111111111111111111111111