11111
10001
10P01
10CE1
11111
