11111111111111111
1P00000000000C001
100000000M0000001
10000000000000001
100000000000000C1
10M00000000M00001
1C000000000000001
10000000000000001
1000000000000M001
100000000000000E1
11111111111111111
