1111111111111111111111111
11P1100000000000000C110C1
10000000000011100M0110001
10C00000000110000011M0001
1000000000110M00000000001
1000000C00011000000000001
1111111000001000001110001
100M0011000000000000100C1
1000000000000001111C1M001
1000011000000011001111111
1C0111000000011000M000001
1111C00000000000000000E01
1111111111111111111111111
