1111111111
1P00C00C1
100000001
10000M001
100000001
10M0000C1
1000M0001
1000000E1
111111111
