11111111111111111111111111111111111111
10P000110000000000000000C0000000M00001
10000000000C00001111111111111000000001
11111111101110001100000000C110000000C1
1M001111111110001C00000M00001000000001
10001110000000000000011C00001000000001
111110000M000M0000000C11110000000M0011
10000000000000000000000000000000000001
1C0000000000000C0001111111111100000001
10000000000000000000000000000000000001
10000001100000000000000000C00000000001
10000M011000000000000111110000000M0001
100000110001000001111100M0000000000001
1C00011000011C00110000000000000M000001
11111100000011111000000000111100000001
100000000000000000000110C00001111100C1
10M000001110000M0000111000000000011111
10000000011100000001110000000C00000001
100000000C1110000C11100000M000000000E1
11111111111111111111111111111111111111
